###########################################
#@......#.............................!...#
#.......#..m..........................!...#
#.......#...........................#.....#
#.......################.......b..!.#.....#
#..........!#.......................#.....#
#..............................######.....#
#..........!...................#..m.#.....#
########################.!.#####....#.....#
#..................................!......#
#.e.....................!.................#
#..................................!......#
###########################################