#########
#@......#
#.......#
#######.#
#.......#
#.......#
#.###################
#!.#................#
#.!#.............e..#
#!.#................#
#.......#############
#.......#
#!......#
#########