#####
#@..#
#...#
#.!.#
#...#
#.!.#
#...#          #####
#...#          #.e.#
#.b.#          #...#
#...#          #...#
#.!.#          #...#
#...#          #.!.#
#...#          #...#
#...#          #...#
#.!.############...#
#......!.........!.#
#..........!.......#
####################