###############
#e...!...!...e#
#......!......#
#.............#
#.!..!.@.!..!.#
#.............#
#......!......#
#e...!.m.!...e#
###############