############################
#..........................#
#.@......................be#
#..........................#
############################