#####################################
#@.......#.........#.......#......m.#
#........#......!..#.....!..........#
#........!.........#................#
#..................#..!....#........#
#........#.........#.......#...!....#
#........#...!.....#.......#.!...!..#
#........#.................#...b....#
#........#.................#.....####
#........#.........#.......#......!.#
#........#....!....#.......#........#
#..!.....#........m#.......#.......e#
#####################################